//MAP CONVERTED BY dmm2tgm.py THIS HEADER COMMENT PREVENTS RECONVERSION, DO NOT REMOVE
"aa" = (
/turf/template_noop,
/area/template_noop)
"ab" = (
/turf/simulated/mineral/random/volcanic,
/area/template_noop)
"ac" = (
/turf/simulated/wall/r_wall,
/area/ruin/powered/hussein)
"ad" = (
/turf/simulated/mineral/random/volcanic,
/area/ruin/powered/hussein)
"ae" = (
/obj/structure/beebox,
/turf/simulated/floor/wood,
/area/ruin/powered/hussein)
"af" = (
/turf/simulated/floor/plating/asteroid,
/area/ruin/powered/hussein)
"ag" = (
/obj/structure/barricade/wooden,
/turf/simulated/floor/plating/asteroid,
/area/ruin/powered/hussein)
"ah" = (
/obj/structure/mineral_door/sandstone,
/turf/simulated/floor/plating/asteroid,
/area/ruin/powered/hussein)
"ai" = (
/turf/simulated/floor/chasm/straight_down/lava_land_surface,
/area/ruin/powered/hussein)
"aj" = (
/obj/machinery/smartfridge/drying_rack,
/turf/simulated/floor/wood,
/area/ruin/powered/hussein)
"al" = (
/turf/simulated/floor/chasm/straight_down/lava_land_surface,
/area/template_noop)
"am" = (
/obj/effect/decal/cleanable/fungus,
/turf/simulated/wall/r_wall,
/area/ruin/powered/hussein)
"an" = (
/obj/structure/rack,
/obj/item/instrument/trombone,
/obj/item/instrument/violin,
/turf/simulated/floor/wood,
/area/ruin/powered/hussein)
"ao" = (
/obj/structure/boulder,
/turf/simulated/wall/r_wall,
/area/ruin/powered/hussein)
"ap" = (
/obj/structure/rack,
/obj/item/instrument/saxophone,
/obj/item/instrument/harmonica,
/turf/simulated/floor/wood,
/area/ruin/powered/hussein)
"aq" = (
/turf/simulated/floor/plating/asteroid/basalt/lava_land_surface,
/area/template_noop)
"ar" = (
/obj/effect/decal/cleanable/glass,
/obj/effect/mob_spawn/human/mime/corpse,
/turf/simulated/floor/plating/asteroid,
/area/ruin/powered/hussein)
"as" = (
/obj/structure/rack,
/obj/item/instrument/accordion,
/obj/item/instrument/trumpet,
/turf/simulated/floor/wood,
/area/ruin/powered/hussein)
"at" = (
/obj/structure/coatrack,
/turf/simulated/floor/plating/asteroid,
/area/ruin/powered/hussein)
"au" = (
/turf/simulated/floor/plating/asteroid/basalt/lava_land_surface,
/area/ruin/powered/hussein)
"av" = (
/obj/structure/boulder,
/turf/simulated/floor/plating/asteroid/basalt/lava_land_surface,
/area/ruin/powered/hussein)
"aw" = (
/obj/effect/mob_spawn/human/corpse/pirate,
/turf/simulated/floor/plating/asteroid,
/area/ruin/powered/hussein)
"ax" = (
/obj/effect/decal/remains/human,
/turf/simulated/floor/plating/asteroid,
/area/ruin/powered/hussein)
"ay" = (
/obj/structure/piano,
/turf/simulated/floor/wood,
/area/ruin/powered/hussein)
"az" = (
/obj/structure/rack/skeletal_bar/left,
/obj/item/instrument/guitar,
/obj/item/instrument/xylophone,
/turf/simulated/floor/wood,
/area/ruin/powered/hussein)
"aA" = (
/obj/machinery/mineral/processing_unit_console,
/turf/simulated/wall/r_wall,
/area/ruin/powered/hussein)
"aB" = (
/obj/structure/rack/skeletal_bar/right,
/obj/item/instrument/eguitar,
/turf/simulated/floor/wood,
/area/ruin/powered/hussein)
"aD" = (
/obj/effect/decal/cleanable/glass,
/turf/simulated/floor/plating/asteroid,
/area/ruin/powered/hussein)
"aE" = (
/obj/effect/mob_spawn/human/clown/corpse,
/turf/simulated/floor/plating/asteroid,
/area/ruin/powered/hussein)
"aF" = (
/obj/effect/decal/cleanable/shreds,
/turf/simulated/floor/plating/asteroid,
/area/ruin/powered/hussein)
"aG" = (
/obj/structure/boulder,
/obj/effect/decal/cleanable/glass,
/turf/simulated/floor/plating/asteroid,
/area/template_noop)
"aH" = (
/obj/effect/turf_decal/sand,
/obj/effect/decal/cleanable/glass,
/turf/simulated/floor/plating/asteroid,
/area/ruin/powered/hussein)
"aI" = (
/obj/effect/decal/cleanable/glass,
/obj/item/beach_ball,
/turf/simulated/floor/wood,
/area/ruin/powered/hussein)
"aJ" = (
/obj/effect/turf_decal/sand,
/turf/simulated/floor/plating/asteroid,
/area/ruin/powered/hussein)
"aK" = (
/obj/structure/boulder,
/turf/simulated/floor/plating/asteroid,
/area/ruin/powered/hussein)
"aL" = (
/obj/effect/turf_decal/sand,
/obj/effect/decal/cleanable/blood/drip,
/turf/simulated/floor/plating/asteroid,
/area/ruin/powered/hussein)
"aM" = (
/turf/simulated/wall/indestructible/necropolis,
/area/ruin/powered/hussein)
"aN" = (
/obj/effect/decal/cleanable/blood/drip,
/turf/simulated/floor/plating/asteroid,
/area/ruin/powered/hussein)
"aO" = (
/obj/machinery/conveyor/south,
/turf/simulated/floor/plating/asteroid,
/area/ruin/powered/hussein)
"aP" = (
/obj/effect/decal/cleanable/fungus,
/turf/simulated/wall/indestructible/necropolis,
/area/ruin/powered/hussein)
"aQ" = (
/obj/item/stack/ore/uranium,
/obj/item/stack/ore/uranium,
/obj/item/stack/ore/uranium,
/turf/simulated/floor/plating/asteroid,
/area/ruin/powered/hussein)
"aR" = (
/obj/machinery/mineral/unloading_machine{
	dir = 1;
	icon_state = "unloader-corner";
	input_dir = 1;
	output_dir = 2
	},
/obj/machinery/conveyor/south,
/turf/simulated/floor/plating/asteroid,
/area/ruin/powered/hussein)
"aS" = (
/obj/machinery/autolathe,
/turf/simulated/floor/wood,
/area/ruin/powered/hussein)
"aT" = (
/obj/machinery/mineral/processing_unit{
	dir = 1;
	output_dir = 2
	},
/obj/machinery/conveyor/south,
/turf/simulated/floor/plating/asteroid,
/area/ruin/powered/hussein)
"aU" = (
/obj/machinery/conveyor/west,
/turf/simulated/floor/plating/asteroid,
/area/ruin/powered/hussein)
"aV" = (
/obj/machinery/conveyor/southwest,
/turf/simulated/floor/plating/asteroid,
/area/ruin/powered/hussein)
"aW" = (
/obj/structure/chair/comfy/beige,
/turf/simulated/floor/wood,
/area/ruin/powered/hussein)
"aX" = (
/obj/machinery/prize_counter,
/turf/simulated/floor/wood,
/area/ruin/powered/hussein)
"aY" = (
/obj/machinery/gameboard,
/turf/simulated/floor/wood,
/area/ruin/powered/hussein)
"aZ" = (
/obj/structure/chair/comfy/beige{
	dir = 8
	},
/turf/simulated/floor/wood,
/area/ruin/powered/hussein)
"ba" = (
/obj/effect/decal/cleanable/blood/gibs/robot/limb,
/turf/simulated/floor/plating/asteroid,
/area/ruin/powered/hussein)
"bb" = (
/obj/machinery/disco{
	anchored = 1
	},
/turf/simulated/floor/light,
/area/ruin/powered/hussein)
"bc" = (
/obj/effect/decal/cleanable/insectguts,
/turf/simulated/floor/plating/asteroid,
/area/ruin/powered/hussein)
"bd" = (
/turf/simulated/floor/wood,
/area/ruin/powered/hussein)
"be" = (
/obj/effect/decal/cleanable/blood/drip,
/turf/simulated/floor/wood,
/area/ruin/powered/hussein)
"bf" = (
/obj/structure/weightmachine/stacklifter,
/turf/simulated/floor/wood,
/area/ruin/powered/hussein)
"bg" = (
/obj/structure/chair/stool,
/obj/effect/decal/cleanable/glass,
/turf/simulated/floor/wood,
/area/ruin/powered/hussein)
"bh" = (
/obj/structure/chair/stool,
/turf/simulated/floor/wood,
/area/ruin/powered/hussein)
"bi" = (
/obj/machinery/computer/arcade/orion_trail,
/turf/simulated/floor/wood,
/area/ruin/powered/hussein)
"bj" = (
/obj/machinery/arcade/claw,
/turf/simulated/floor/wood,
/area/ruin/powered/hussein)
"bk" = (
/obj/machinery/slot_machine,
/turf/simulated/floor/wood,
/area/ruin/powered/hussein)
"bl" = (
/obj/structure/weightmachine/weightlifter,
/turf/simulated/floor/wood,
/area/ruin/powered/hussein)
"bm" = (
/obj/structure/spawner/hussein_oil,
/turf/simulated/floor/plating/asteroid,
/area/ruin/powered/hussein)
"bn" = (
/obj/machinery/atmospherics/pipe/cap/visible/supply,
/obj/item/fan,
/turf/simulated/floor/plating/asteroid,
/area/ruin/powered/hussein)
"bo" = (
/obj/machinery/atmospherics/unary/vent_pump,
/turf/simulated/floor/plating/asteroid,
/area/ruin/powered/hussein)
"bp" = (
/turf/simulated/floor/light,
/area/ruin/powered/hussein)
"bq" = (
/obj/structure/bookcase/random/religion,
/turf/simulated/floor/plating/asteroid,
/area/ruin/powered/hussein)
"br" = (
/obj/item/toy/russian_revolver/trick_revolver,
/obj/structure/window/reinforced{
	dir = 1;
	layer = 2.9
	},
/obj/structure/window/reinforced,
/obj/structure/window/reinforced{
	dir = 8
	},
/turf/simulated/floor/grass,
/area/ruin/powered/hussein)
"bs" = (
/obj/effect/decal/cleanable/molten_object,
/obj/structure/table/wood,
/obj/item/candle,
/turf/simulated/floor/plating/asteroid,
/area/ruin/powered/hussein)
"bt" = (
/obj/effect/minecraft,
/turf/simulated/floor/grass,
/area/ruin/powered/hussein)
"bu" = (
/obj/effect/decal/cleanable/glass,
/mob/living/simple_animal/goossein,
/turf/simulated/floor/plating/asteroid,
/area/ruin/powered/hussein)
"bv" = (
/obj/effect/decal/cleanable/vomit,
/turf/simulated/floor/light,
/area/ruin/powered/hussein)
"bw" = (
/obj/structure/boulder,
/turf/simulated/wall/indestructible/necropolis,
/area/ruin/powered/hussein)
"bx" = (
/obj/structure/bed/psych,
/obj/item/bedsheet/syndie,
/obj/item/storage/bible,
/turf/simulated/floor/plating/asteroid,
/area/ruin/powered/hussein)
"by" = (
/obj/structure/table/wood,
/obj/machinery/chem_dispenser/soda,
/turf/simulated/floor/plating/asteroid,
/area/ruin/powered/hussein)
"bz" = (
/obj/effect/decal/cleanable/blood/drip,
/obj/effect/mob_spawn/human/corpse/russian,
/turf/simulated/floor/plating/asteroid,
/area/ruin/powered/hussein)
"bA" = (
/obj/structure/mirror{
	dir = 4;
	pixel_x = 32
	},
/obj/effect/decal/cleanable/blood,
/obj/effect/decal/cleanable/blood/drip,
/obj/effect/decal/cleanable/blood/innards,
/turf/simulated/floor/plating/asteroid,
/area/ruin/powered/hussein)
"bB" = (
/obj/structure/falsewall/reinforced,
/turf/simulated/floor/plating/asteroid,
/area/ruin/powered/hussein)
"bC" = (
/obj/effect/decal/remains/human,
/obj/effect/decal/cleanable/glass,
/obj/effect/decal/cleanable/vomit/green,
/turf/simulated/floor/plating/asteroid,
/area/ruin/powered/hussein)
"bD" = (
/obj/effect/decal/cleanable/vomit,
/turf/simulated/floor/plating/asteroid,
/area/ruin/powered/hussein)
"bE" = (
/obj/structure/table/wood,
/obj/machinery/chem_dispenser/beer,
/turf/simulated/floor/plating/asteroid,
/area/ruin/powered/hussein)
"bF" = (
/obj/structure/table/wood,
/obj/item/reagent_containers/glass/rag,
/obj/item/reagent_containers/food/drinks/shaker,
/obj/structure/window/reinforced{
	dir = 8
	},
/turf/simulated/floor/plating/asteroid,
/area/ruin/powered/hussein)
"bG" = (
/obj/machinery/vending/dinnerware,
/obj/structure/window/reinforced{
	dir = 8
	},
/turf/simulated/floor/plating/asteroid,
/area/ruin/powered/hussein)
"bH" = (
/obj/structure/sign/goldenplaque{
	desc = "A sign.";
	name = "The Air Fryer"
	},
/turf/simulated/wall/r_wall,
/area/ruin/powered/hussein)
"bI" = (
/obj/structure/sign/goldenplaque{
	desc = "A sign.";
	name = "Light Music Room"
	},
/turf/simulated/wall/r_wall,
/area/ruin/powered/hussein)
"bJ" = (
/obj/structure/sign/goldenplaque{
	desc = "A sign.";
	name = "Blacksmith Forge Room"
	},
/turf/simulated/wall/r_wall,
/area/ruin/powered/hussein)
"bK" = (
/obj/structure/sign/goldenplaque{
	desc = "A sign.";
	name = "Cum Zone. Go ahead."
	},
/turf/simulated/wall/r_wall,
/area/ruin/powered/hussein)
"bL" = (
/obj/structure/sign/goldenplaque{
	desc = "A sign.";
	name = "Gaming Room"
	},
/turf/simulated/wall/r_wall,
/area/ruin/powered/hussein)
"bM" = (
/obj/structure/sign/goldenplaque{
	desc = "A sign.";
	name = "Minecraft Room"
	},
/turf/simulated/wall/r_wall,
/area/ruin/powered/hussein)
"bN" = (
/obj/structure/sign/goldenplaque{
	desc = "A sign.";
	name = "Cool Party Ahead"
	},
/turf/simulated/wall/r_wall,
/area/ruin/powered/hussein)
"bO" = (
/obj/structure/sign/goldenplaque{
	desc = "A sign.";
	name = "Gym"
	},
/turf/simulated/wall/r_wall,
/area/ruin/powered/hussein)
"bP" = (
/obj/structure/sign/goldenplaque{
	desc = "A sign.";
	name = "Bedroom"
	},
/turf/simulated/wall/r_wall,
/area/ruin/powered/hussein)
"bQ" = (
/obj/machinery/conveyor/south,
/obj/item/stack/ore/uranium,
/turf/simulated/floor/plating/asteroid,
/area/ruin/powered/hussein)
"bR" = (
/obj/machinery/mineral/mint,
/obj/item/clothing/gloves/ring/uranium,
/turf/simulated/floor/wood,
/area/ruin/powered/hussein)
"bS" = (
/obj/item/clothing/gloves/ring/uranium,
/turf/simulated/floor/plating/asteroid,
/area/ruin/powered/hussein)
"bT" = (
/obj/item/storage/toolbox/mechanical/old,
/turf/simulated/floor/plating/asteroid,
/area/ruin/powered/hussein)
"bU" = (
/obj/item/beach_ball/holoball,
/turf/simulated/floor/wood,
/area/ruin/powered/hussein)
"bW" = (
/obj/structure/chair/stool,
/turf/simulated/floor/plating/asteroid,
/area/ruin/powered/hussein)
"gk" = (
/turf/simulated/floor/plating/lava/smooth/lava_land_surface,
/area/template_noop)
"YL" = (
/turf/simulated/floor/plating/lava/smooth/lava_land_surface,
/area/ruin/powered/hussein)

(1,1,1) = {"
aa
aa
aa
aa
aa
aq
aq
aq
aq
aa
aa
aa
aa
aa
aa
aa
aa
aa
aa
aa
aa
aa
aa
aa
aa
aa
aa
aa
aa
aa
"}
(2,1,1) = {"
aa
aa
aa
aa
ab
aq
aq
aq
aq
ab
aa
aa
aa
aa
aa
aa
aa
aa
aa
aa
aa
aa
aa
aa
aa
aa
aa
aa
aa
aa
"}
(3,1,1) = {"
ab
ab
ab
ab
ab
ab
aq
au
ab
ab
aa
aa
aa
aa
aa
aa
aa
aa
aa
aa
aa
aa
aa
aa
aa
aa
aa
aa
aa
aa
"}
(4,1,1) = {"
ab
ac
ac
ac
ab
ab
ab
av
ab
ab
aa
aa
aa
aa
aa
aa
aa
aa
aa
aa
aa
aa
aa
aa
aa
aa
aa
aa
aa
aa
"}
(5,1,1) = {"
ac
ae
aj
aj
ac
ab
ac
av
ac
ab
aa
aa
aa
aa
aa
aa
aa
aa
aa
aa
aa
aa
aa
aa
aa
aa
aa
aa
aa
aa
"}
(6,1,1) = {"
ac
af
af
af
af
ac
ac
ah
ac
ab
ab
ab
ab
ab
aa
aa
aa
aa
aa
ab
ab
ab
ab
ab
aa
aa
aa
aa
aa
aa
"}
(7,1,1) = {"
ac
ag
am
am
ah
ac
at
af
ac
YL
YL
ac
ac
ab
ab
ab
aa
aa
ab
ab
aM
aP
aM
ab
ab
ab
ab
ab
aa
aa
"}
(8,1,1) = {"
ad
ag
ad
bH
af
YL
YL
aD
aH
af
af
af
af
bK
al
ab
ab
aa
ab
aM
ai
br
ai
aM
am
am
ac
ab
ab
aa
"}
(9,1,1) = {"
ad
ag
ad
ac
af
YL
YL
YL
aJ
ac
YL
YL
ax
ah
al
al
ab
ab
ab
ac
ai
bt
ai
ba
ah
af
af
ac
ab
aa
"}
(10,1,1) = {"
ad
af
ad
YL
af
YL
YL
YL
aL
ac
YL
YL
YL
ac
al
ab
ab
ac
ac
af
ai
af
ai
aD
bP
bq
aN
ac
ab
aa
"}
(11,1,1) = {"
ad
af
ad
YL
af
YL
ac
aE
af
ac
YL
YL
YL
YL
ab
ab
ac
af
ah
af
af
af
af
aD
am
bx
bz
ac
ab
aa
"}
(12,1,1) = {"
ad
af
ad
YL
aw
af
af
af
af
af
af
af
ac
YL
ab
ab
ac
ba
ac
ac
ac
ac
ac
ac
am
bs
bA
ac
ab
aa
"}
(13,1,1) = {"
ad
af
ad
YL
YL
YL
YL
ac
af
am
YL
af
af
YL
ab
ab
ac
ah
bM
ab
ab
ab
ab
ab
ac
bB
ac
ab
ab
aa
"}
(14,1,1) = {"
ad
af
ad
ac
ac
YL
YL
af
af
YL
YL
YL
af
YL
ab
ac
aX
af
af
ac
ab
ab
ab
bw
aK
aK
ac
ab
ab
aa
"}
(15,1,1) = {"
ad
ag
ad
YL
YL
YL
YL
af
ac
YL
YL
YL
af
bL
ac
af
af
af
bg
bi
ac
ab
bw
af
bn
bw
ab
ab
ab
aa
"}
(16,1,1) = {"
ad
af
ad
YL
ax
af
af
aF
aF
YL
ac
YL
af
af
ah
af
af
bu
aD
bj
ac
ab
bw
bm
bo
bw
ab
ab
ab
aa
"}
(17,1,1) = {"
ac
ag
ac
aK
ao
ah
bI
ac
YL
YL
ac
am
am
am
ac
aW
aY
af
bh
bk
ac
ab
ab
bw
bw
ab
ab
ab
ab
aa
"}
(18,1,1) = {"
ac
af
af
aK
aK
aK
ac
ab
YL
ab
ab
ab
ab
ab
ab
ac
aZ
af
aK
ac
ab
ab
ab
ab
ab
ab
ab
ab
ab
aa
"}
(19,1,1) = {"
ac
ah
ac
ac
ac
ac
ac
ab
ab
gk
gk
gk
gk
ab
ab
ab
ac
ah
bN
YL
YL
am
am
am
ac
ac
ac
ab
ab
ab
"}
(20,1,1) = {"
ac
af
ac
ap
ay
ac
ab
ab
ab
gk
ac
ac
gk
gk
ab
ab
YL
bc
YL
YL
ax
YL
YL
ah
af
aN
aN
ac
ac
ab
"}
(21,1,1) = {"
ac
af
af
ar
ar
az
ac
al
ab
ac
bR
bS
ac
gk
gk
ab
ac
ag
ac
ac
ac
ac
ac
ac
YL
af
aN
af
YL
ab
"}
(22,1,1) = {"
ab
ac
an
aK
ar
aB
bJ
aG
aG
ac
aK
af
bT
ac
gk
ab
ad
ag
ad
ad
ad
ad
ad
ac
YL
YL
bp
bD
YL
ab
"}
(23,1,1) = {"
ab
ab
ac
as
af
af
ah
af
aN
ah
af
af
aS
ac
gk
gk
ad
ag
ac
YL
YL
YL
ad
YL
YL
bb
bp
af
ac
ab
"}
(24,1,1) = {"
aa
ab
ab
ac
ac
aK
ac
ac
YL
am
aK
af
aF
aU
ac
gk
ac
af
aK
aI
af
am
am
YL
bp
bv
bp
af
ac
ab
"}
(25,1,1) = {"
aa
aa
ab
ab
ab
ab
ab
ab
ac
aQ
aQ
af
aA
aU
ac
gk
ac
bU
bd
bl
aD
ah
af
af
af
af
af
af
ac
ab
"}
(26,1,1) = {"
aa
aa
aa
aa
aa
aa
ab
ab
ac
bQ
aR
aO
aT
aV
ac
ab
YL
be
bd
bd
bd
ac
bO
af
af
bF
bG
ac
ac
ab
"}
(27,1,1) = {"
aa
aa
aa
aa
aa
aa
aa
aa
ab
ac
ac
ac
ac
ac
ab
ab
YL
bf
bd
bl
ac
ac
ab
ac
af
bW
bC
ac
YL
ab
"}
(28,1,1) = {"
aa
aa
aa
aa
aa
aa
aa
aa
ab
ab
ab
ab
ab
ab
ab
ab
ab
ac
YL
YL
ac
ab
ab
ab
ac
by
bE
ac
ab
ab
"}
(29,1,1) = {"
aa
aa
aa
aa
aa
aa
aa
aa
aa
aa
aa
aa
aa
aa
aa
aa
ab
ab
ab
ab
ab
ab
ab
ab
ab
ac
ac
ab
ab
aa
"}
(30,1,1) = {"
aa
aa
aa
aa
aa
aa
aa
aa
aa
aa
aa
aa
aa
aa
aa
aa
aa
aa
aa
aa
aa
aa
aa
aa
ab
ab
ab
ab
aa
aa
"}
